PARM	PARM_DESCRIPTION	Description	Label
AGUT	SILVER,   UNFILTERED TOTAL	SILVER,   UNFILTERED TOTAL;MICROGRAM PER LITER	Ag (µg/L)
ALKT	ALKALINITY, TOTAL	ALKALINITY, TOTAL;MILLIGRAM PER LITER	Alk (mg/L)
ALUT	ALUMINIUM, UNFILTERED TOTAL	ALUMINIUM, UNFILTERED TOTAL;MICROGRAM PER LITER	Al (µg/L)
ANIONS	ANIONS	ANIONS;MILLIEQUIVALENTS/LITER	Anions (meq/L)
ASUT	ARSENIC,    UNFILTERED TOTAL	ARSENIC,    UNFILTERED TOTAL;MILLIGRAM PER LITER	As (µg/l)
BAUT	BARIUM,  UNFILTERED TOTAL	BARIUM,  UNFILTERED TOTAL;MICROGRAM PER LITER	Ba (µg/L)
BEUT	BERYLIUM,UNFILTERED TOTAL	BERYLIUM,UNFILTERED TOTAL;MICROGRAM PER LITER	Be (µg/L)
BIUT	BISMUTH, UNFILTERED TOTAL	BISMUTH, UNFILTERED TOTAL;MICROGRAM PER LITER	Bi (µg/L)
BOD5	BOD,  5 DAY,  TOTAL DEMAND	BOD,  5 DAY,  TOTAL DEMAND;MILLIGRAM PER LITER	BOD (mg/L)
CAUT	CALCIUM, UNFILTERED TOTAL	CALCIUM, UNFILTERED TOTAL;MILLIGRAM PER LITER	Ca (mg/L)
CDUT	CADMIUM, UNFILTERED TOTAL	CADMIUM, UNFILTERED TOTAL;MICROGRAM PER LITER	Cd (µg/L)
CHLRAC	CHLOROPHYLL-A, CORRECTED	CHLOROPHYLL-A, CORRECTED;MICROGRAM PER LITER	
CHLRAT	CHLOROPHYLL-A, TOTAL	CHLOROPHYLL-A, TOTAL;MICROGRAM PER LITER	
CHLRBT	CHLOROPHYLL-B, TOTAL	CHLOROPHYLL-B, TOTAL;MICROGRAM PER LITER	
CLIDUR	CHLORIDE,         UNFIL.REAC	CHLORIDE,         UNFIL.REAC;MILLIGRAM PER LITER	Cl (mg/L)
COD	CHEMICAL OXYGEN DEMAND	CHEMICAL OXYGEN DEMAND;MILLIGRAM PER LITER	
COLTR	COLOUR, TRUE	COLOUR, TRUE;TRUE COLOUR UNITS (TCU)	
COND25	CONDUCTIVITY, 25C	CONDUCTIVITY, 25C;MICRO SIEMENS PER CENTIMETER	Cond(µS, 25°)
CONDAM	CONDUCTIVITY, AMBIENT	CONDUCTIVITY, AMBIENT;MICROMHOS/CM (CONDUCTIVITY)	Cond(µS, ambient)
CONDTY	CONDUCTIVITY, ESTIMATED	CONDUCTIVITY, ESTIMATED;MICRO SIEMENS PER CENTIMETER	
COUT	COBALT,   UNFILTERED TOTAL	COBALT,   UNFILTERED TOTAL;MICROGRAM PER LITER	
CRUT	CHROMIUM, UNFILTERED TOTAL	CHROMIUM, UNFILTERED TOTAL;MICROGRAM PER LITER	Cr (µg/L)
CUUT	COPPER,   UNFILTERED TOTAL	COPPER,   UNFILTERED TOTAL;MICROGRAM PER LITER	Cu (µg/L)
DIC	CARBON, DISSOLVED INORGANIC	CARBON, DISSOLVED INORGANIC;MILLIGRAM PER LITER	DIC (mg/L)
DO	DISSOLVED OXYGEN	DISSOLVED OXYGEN;MILLIGRAM PER LITER	DO (mg/L)
DOC	CARBON, DISSOLVED ORGANIC	CARBON, DISSOLVED ORGANIC;MILLIGRAM PER LITER	
ECMF	ESCHERICHIA COLI MF	ESCHERICHIA COLI MF;COUNTS	
FEUT	IRON,     UNFILTERED TOTAL	IRON,     UNFILTERED TOTAL;MICROGRAM PER LITER	Fe (µg/L)
FSMF	FECAL STREPTOCOCCUS MF	FECAL STREPTOCOCCUS MF;COUNTS	
FWPH	PH FIELD	PH FIELD;NO DIMENSION/SCALE	Ph field
FWSTRC	STREAM CONDITION	STREAM CONDITION;NO DIMENSION/SCALE	
FWTEMP	TEMPERATURE, WATER	TEMPERATURE, WATER;DEGREES CELSIUS	
GROSSA	GROSS ALPHA-HIVOLS-RPL	GROSS ALPHA-HIVOLS-RPL;BECQUEREL PER LITRE	
GROSSB	GROSS B-HIVOLS-RPL	GROSS B-HIVOLS-RPL;BECQUEREL PER LITRE	
HARDT	HARDNESS,   TOTAL	HARDNESS,   TOTAL;MILLIGRAM PER LITER	
HGUT	MERCURY,  UNFILTERED TOTAL	MERCURY,  UNFILTERED TOTAL;MICROGRAM PER LITER	
HH3	TRITIUM,  (HYDROGEN 3)	TRITIUM,  (HYDROGEN 3);BECQUEREL PER LITRE	
KKUT	POTASSIUM,UNFILTERED TOTAL	POTASSIUM,UNFILTERED TOTAL;MILLIGRAM PER LITER	
LIUT	LITHIUM,  UNFILTERED TOTAL	LITHIUM,  UNFILTERED TOTAL;MICROGRAM PER LITER	
MGUT	MAGNESIUM,UNFILTERED TOTAL	MAGNESIUM,UNFILTERED TOTAL;MILLIGRAM PER LITER	Mg (mg/L)
MNUT	MANGANESE,UNFILTERED TOTAL	MANGANESE,UNFILTERED TOTAL;MICROGRAM PER LITER	Mn (mg/L)
MOUT	MOLYBDENUM,UNFILTERED TOTAL	MOLYBDENUM,UNFILTERED TOTAL;MICROGRAM PER LITER	
MTH01	METHOPRENE	METHOPRENE;NANOGRAM PER LITER	
MTH02	METHOPRENE ACID	METHOPRENE ACID;NANOGRAM PER LITER	
MTH03	METHOXYCITRONELLAL	METHOXYCITRONELLAL;NANOGRAM PER LITER	
NAUT	SODIUM,   UNFILTERED TOTAL	SODIUM,   UNFILTERED TOTAL;MILLIGRAM PER LITER	Na (mg/L)
NIUT	NICKEL,   UNFILTERED TOTAL	NICKEL,   UNFILTERED TOTAL;MICROGRAM PER LITER	
NNHTUR	AMMONIUM, TOTAL   UNFIL.REAC	AMMONIUM, TOTAL   UNFIL.REAC;MILLIGRAM PER LITER	
NNO2UR	NITRITE,  UNFILTERED REACTIVE	NITRITE,  UNFILTERED REACTIVE;MILLIGRAM PER LITER	
NNO3UR	NITRATE,  UNFILTERED REACTIVE	NITRATE,  UNFILTERED REACTIVE;MILLIGRAM PER LITER	
NNOTUR	NITRATES TOTAL,   UNFIL.REAC	NITRATES TOTAL,   UNFIL.REAC;MILLIGRAM PER LITER	
NNTKUR	NITROGEN,TOT,KJELDAHL/UNF.REA	NITROGEN,TOT,KJELDAHL/UNF.REA;MILLIGRAM PER LITER	
NTOT	NITROGEN; TOTAL	NITROGEN; TOTAL;MILLIGRAM PER LITER	
P1ALDR	ALDRIN	ALDRIN;NANOGRAM PER LITER	
P1BHCA	HEXACLOROCYCLOHEX,ALPHA-BHC	HEXACLOROCYCLOHEX,ALPHA-BHC;NANOGRAM PER LITER	
P1BHCB	HEXACLOROCYCLOHEX,BETA-BHC	HEXACLOROCYCLOHEX,BETA-BHC;NANOGRAM PER LITER	
P1BHCG	HEXACLOROCYCLOHEX,GAMMA-BHC	HEXACLOROCYCLOHEX,GAMMA-BHC;NANOGRAM PER LITER	
P1CHLA	CHLORDANE,ALPHA	CHLORDANE,ALPHA;NANOGRAM PER LITER	
P1CHLG	CHLORDANE,GAMMA	CHLORDANE,GAMMA;NANOGRAM PER LITER	
P1DIEL	DIELDRIN	DIELDRIN;NANOGRAM PER LITER	
P1DMDT	DMDT METHOXYCHLOR	DMDT METHOXYCHLOR;NANOGRAM PER LITER	
P1END1	ENDOSULFAN I	ENDOSULFAN I;NANOGRAM PER LITER	
P1END2	ENDOSULFAN II	ENDOSULFAN II;NANOGRAM PER LITER	
P1ENDR	ENDRIN	ENDRIN;NANOGRAM PER LITER	
P1ENDS	ENDOSULFAN,SULPHATE	ENDOSULFAN,SULPHATE;NANOGRAM PER LITER	
P1HEPE	HEPTACHLOREPOXIDE	HEPTACHLOREPOXIDE;NANOGRAM PER LITER	
P1HEPT	HEPTACHLOR	HEPTACHLOR;NANOGRAM PER LITER	
P1MIRX	MIREX	MIREX;NANOGRAM PER LITER	
P1OCHL	OXYCHLORDANE	OXYCHLORDANE;NANOGRAM PER LITER	
P1OPDT	OP-DDT	OP-DDT;NANOGRAM PER LITER	
P1PCBT	PCB TOTAL	PCB TOTAL;NANOGRAM PER LITER	
P1PPDD	PP-DDD	PP-DDD;NANOGRAM PER LITER	
P1PPDE	PP-DDE	PP-DDE;NANOGRAM PER LITER	
P1PPDT	PP-DDT	PP-DDT;NANOGRAM PER LITER	
P1TOX	TOXAPHENE	TOXAPHENE;NANOGRAM PER LITER	
P1TRIF	TRIFLURALIN	TRIFLURALIN;NANOGRAM PER LITER	
P4MALA	MALATHION	MALATHION;NANOGRAM PER LITER	
PBUT	LEAD,     UNFILTERED TOTAL	LEAD,     UNFILTERED TOTAL;MICROGRAM PER LITER	
PERMET	PERMETHRIN	PERMETHRIN;NANOGRAM PER LITER	
PH	PH (-LOG H+ CONCN)	PH (-LOG H+ CONCN);NO DIMENSION/SCALE	
PHNOL	PHENOLICS, UNFILERED REACTIVE	PHENOLICS, UNFILERED REACTIVE;MICROGRAM PER LITER	
PIPBUT	PIPERONYL BUTOXIDE	PIPERONYL BUTOXIDE;NANOGRAM PER LITER	
PPO4FR	PHOSPHATE,FILTERED REACTIVE	PHOSPHATE,FILTERED REACTIVE;MILLIGRAM PER LITER	
PPUT	PHOSPHORUS,UNFILTERED TOTAL	PHOSPHORUS,UNFILTERED TOTAL;MILLIGRAM PER LITER	
PSAMF	PSEUDOMON.AERUGINOSA MF	PSEUDOMON.AERUGINOSA MF;COUNTS	
PSIZE1	PARTICLES,  1000-2000 MICRONS	PARTICLES,  1000-2000 MICRONS;PERCENT	
PSIZE4	PARTICLES,  42.2-1000 MICRONS	PARTICLES,  42.2-1000 MICRONS;PERCENT	
PSIZE5	PARTICLES, <42.2 MICRO	PARTICLES, <42.2 MICRO;PERCENT	
PTC	PARTICULATE, TOTAL CARBON	PARTICULATE, TOTAL CARBON;MILLIGRAM PER LITER	
PYRE1	PYRETHRIN 1	PYRETHRIN 1;NANOGRAM PER LITER	
PYRE2	PYRETHRIN 2	PYRETHRIN 2;NANOGRAM PER LITER	
PZ062	PARTICLES,  <  62     MICRONS	PARTICLES,  <  62     MICRONS;PERCENT	
PZ088	PARTICLES, < 88 MICRONS	PARTICLES, < 88 MICRONS;PERCENT	
PZ1000	PARTICLES, 704-1000  MICRONS	PARTICLES, 704-1000  MICRONS;PERCENT	
PZ10D5	PARTICLES,  <  10.55  MICRONS	PARTICLES,  <  10.55  MICRONS;PERCENT	
PZ125	PARTICLES,  < 125     MICRONS	PARTICLES,  < 125     MICRONS;PERCENT	
PZ14D9	PARTICLES,  <  14.92  MICRONS	PARTICLES,  <  14.92  MICRONS;PERCENT	
PZ176	PARTICLES,  < 176     MICRONS	PARTICLES,  < 176     MICRONS;PERCENT	
PZ1D01	PARTICLES,  <   1.01  MICRONS	PARTICLES,  <   1.01  MICRONS;PERCENT	
PZ1D69	PARTICLES,  <   1.69  MICRONS	PARTICLES,  <   1.69  MICRONS;PERCENT	
PZ21D1	PARTICLES,  <  21.1   MICRONS	PARTICLES,  <  21.1   MICRONS;PERCENT	
PZ250	PARTICLES,  < 250     MICRONS	PARTICLES,  < 250     MICRONS;PERCENT	
PZ29D8	PARTICLES,  <  29.85  MICRONS	PARTICLES,  <  29.85  MICRONS;PERCENT	
PZ2D63	PARTICLES,  <   2.63  MICRONS	PARTICLES,  <   2.63  MICRONS;PERCENT	
PZ352	PARTICLES,  < 352     MICRONS	PARTICLES,  < 352     MICRONS;PERCENT	
PZ3D73	PARTICLES,  <   3.73  MICRONS	PARTICLES,  <   3.73  MICRONS;PERCENT	
PZ42D2	PARTICLES,  <  42.21  MICRONS	PARTICLES,  <  42.21  MICRONS;PERCENT	
PZ500	PARTICLES,  < 500     MICRONS	PARTICLES,  < 500     MICRONS;PERCENT	
PZ5D27	PARTICLES,  <   5.27  MICRONS	PARTICLES,  <   5.27  MICRONS;PERCENT	
PZ704	PARTICLES,  < 704     MICRONS	PARTICLES,  < 704     MICRONS;PERCENT	
PZ7D46	PARTICLES,  <   7.46  MICRONS	PARTICLES,  <   7.46  MICRONS;PERCENT	
PZD211	PARTICLES,  <    .21  MICRONS	PARTICLES,  <    .21  MICRONS;PERCENT	
PZD34	PARTICLES,  <    .34  MICRONS	PARTICLES,  <    .34  MICRONS;PERCENT	
PZD43	PARTICLES,  <    .43  MICRONS	PARTICLES,  <    .43  MICRONS;PERCENT	
PZD66	PARTICLES,  <    .66  MICRONS	PARTICLES,  <    .66  MICRONS;PERCENT	
RAD226	RADIUM 226-HIVOLS-RPL	RADIUM 226-HIVOLS-RPL;BECQUEREL PER LITRE	
RSF	RESIDUE,FILTERED	RESIDUE,FILTERED;MILLIGRAM PER LITER	
RSFEST	SOLIDS; DISSOLVED ESTIMATED	SOLIDS; DISSOLVED ESTIMATED;MILLIGRAM PER LITER	
RSP	RESIDUE,PARTICULATE	RESIDUE,PARTICULATE;MILLIGRAM PER LITER	
RST	RESIDUE,TOTAL	RESIDUE,TOTAL;MILLIGRAM PER LITER	
SEUT	SELENIUM, UNFILTERED TOTAL	SELENIUM, UNFILTERED TOTAL;MILLIGRAM PER LITER	
SIO3UR	SILICATES,UNFILTERED REACTIVE	SILICATES,UNFILTERED REACTIVE;MILLIGRAM PER LITER	
SNUT	TIN       UNFILTERED TOTAL	TIN       UNFILTERED TOTAL;MICROGRAM PER LITER	
SRUT	STRONTIUM, UNFILTERED TOTAL	STRONTIUM, UNFILTERED TOTAL;MICROGRAM PER LITER	
SSO4UR	SULPHATE, UNFILTERED REACTIVE	SULPHATE, UNFILTERED REACTIVE;MILLIGRAM PER LITER	
SUM2	% <62 UM, >2.63 UM, SUM	% <62 UM, >2.63 UM, SUM;PERCENT	
SUM4	% <1000 UM, >62 UM, SUM	% <1000 UM, >62 UM, SUM;PERCENT	
SUM5	% <2.63 UM, >0.10 UM, SUM	% <2.63 UM, >0.10 UM, SUM;PERCENT	
TIUT	TITANIUM,  UNFILTERED TOTAL	TITANIUM,  UNFILTERED TOTAL;MICROGRAM PER LITER	
TOC	CARBON, TOTAL ORGANIC	CARBON, TOTAL ORGANIC;MILLIGRAM PER LITER	
TURB	TURBIDITY	TURBIDITY;FORMAZIN TURBIDITY UNIT	
UUUT	URANIUM,   UNFILTERED TOTAL	URANIUM,   UNFILTERED TOTAL;MICROGRAM PER LITER	
VVUT	VANADIUM,  UNFILTERED TOTAL	VANADIUM,  UNFILTERED TOTAL;MICROGRAM PER LITER	
X1HCBD	HEXACHLOROBUTADIENE	HEXACHLOROBUTADIENE;NANOGRAM PER LITER	
X1HCCP	HEXACHLORO CYCLO PENTADIENE	HEXACHLORO CYCLO PENTADIENE;NANOGRAM PER LITER	
X2123	TRICHLOROBENZENE   1,2,3	TRICHLOROBENZENE   1,2,3;NANOGRAM PER LITER	
X21234	TETRACHLOROBENZENE 1,2,3,4	TETRACHLOROBENZENE 1,2,3,4;NANOGRAM PER LITER	
X21235	TETRACHLOROBENZENE 1,2,3,5	TETRACHLOROBENZENE 1,2,3,5;NANOGRAM PER LITER	
X2124	TRICHLOROBENZENE   1,2,4	TRICHLOROBENZENE   1,2,4;NANOGRAM PER LITER	
X21245	TETRACHLOROBENZENE 1,2,4,5	TETRACHLOROBENZENE 1,2,4,5;NANOGRAM PER LITER	
X2135	TRICHLOROBENZENE   1,3,5	TRICHLOROBENZENE   1,3,5;NANOGRAM PER LITER	
X2HCB	HEXACHLOROBENZENE	HEXACHLOROBENZENE;NANOGRAM PER LITER	
X2HCE	HEXACHLOROETHANE	HEXACHLOROETHANE;NANOGRAM PER LITER	
X2OCST	OCTACHLOROSTYRENE	OCTACHLOROSTYRENE;NANOGRAM PER LITER	
X2PNCB	PENTACHLOROBENZENE	PENTACHLOROBENZENE;NANOGRAM PER LITER	
X2T236	TRICHLOROTOLUENE   2,3,6	TRICHLOROTOLUENE   2,3,6;NANOGRAM PER LITER	
X2T245	TRICHLOROTOLUENE   2,4,5	TRICHLOROTOLUENE   2,4,5;NANOGRAM PER LITER	
X2T26A	TRICHLOROTOLUENE   2,6,A	TRICHLOROTOLUENE   2,6,A;NANOGRAM PER LITER	
ZNUT	ZINC,  UNFILTERED TOTAL	ZINC,  UNFILTERED TOTAL;MICROGRAM PER LITER	
ZRUT	ZIRCONIUM,  UNFILTERED TOTAL	ZIRCONIUM,  UNFILTERED TOTAL;MICROGRAM PER LITER	
